1111111111111111111111111111111111111111111
1PCCCCCCXCCCCCCCCCCCCCCCCCCCCCCCCCCCCCCC1C1
1CCCCCCCCCCCCCCC1CCCCCCCCCCCCCCCCCCCCCCCC01
1CCCCCCCCCCCCCCCCCCCCCCCCCCCCCCCCCCCCCCCCC1
1CCCCCCCCCCCCCCCCCCCCCCCCCCCCCCCCCCCCCCCCC1
1CCCCCCCCCC1CCCCCCCCCCCCCCCCCCCCCCCCCCCCCC1
1CCCCCCCCCCCCCCC1CCCCCCCCCCCCCCCCCCCCCCCCC1
1CCCCCCCCCCCCCCCCCCCCCCCCCCCCCCCCCCCCCCCCC1
1CCCCCCCCCC1CCCCCCCCCCCCCCCCCCCCCCCCCCCCCC1
1CCCCCCCCCCCCCCCCCCC1CCCCCCCCCCCCCCCCCCCCC1
1CCC1CCCCCCCCCCCCCCCCCCCCCCCCCCCCCCCCCCCCC1
1CCCCCCCCCCCCCCCCCCCCCCC1CCCCCCCCCCCCCCCCC1
1CCCCCCCCCCC1CCCCCCCCCCCCCCCCCCCCCCCCCCCCC1
1CCCCCCCCCCCCCCCCC1CCCCCCCCCCCCCCCCCCCCCCC1
1CCCCCCCCCCCCCCCCCCCCCCCCCCCCCCCCCCCCCCCCC1
1CCCCCCCCCCCCCCCCCCCCCCCC1CCCCCCCCCCCCCCCE1
1111111111111111111111111111111111111111111
