1111111111111111111111111111111111
1E00000000000001000001000000000001
1010010100100000101001000000010101
1010011010101010001C01000000010101
10P000000C001000100000000000000011
1111111111111111111111111111111111