11111111111111
1E0000000P0001
10C00000000001
11111111111111
