000XXXXX000000001111000
01111111111111111111110
0111000000000010EP00010
01000000000000100001100
01000000000000101111110
0100000000000010000XC10
01000000000000000C00C10
01111111111111111111110
00000000000000000000000
01111111111111111111110
01000000000000000000010
01111111111111111111110
00000000000000000000000
