11111111
111000C1
1E0CP001
11111111
