11111111
10000XC1
1E0CP011
11111111
