11111111
11000001
1C0EP001
11111111
