11111111
110000C1
1E10P001
11111111
