111111111111111111111
100000000000010000001
111000000000010E0P001
100000000000010110111
100000000000010111111
100000000000010000XC1
1000000000000000C00C1
111111111111111111111
