111111111
110101001
1010C1001
10110P101
1E1000101
111111111
